111111111111111
10000P0001000C1
100000010100001
100000010100001
1000000100000E1
111111111111111