111111111111111
1C000P0001C00C1
100000010100001
100000010100001
100000C100000E1
111111111111111